     #.## ######## ##.#
     #.##    P     ##.#     
######.## ######## ##.######
#............##............#
#.####.#####.##.#####.####.#
#X..##................##..X#
###.##.##.########.##.##.###
#......##....##....##......#
#.##########.##.##########.#
#..........................#
############################