############################
#............##............#
#.####.#####.##.#####.####.#
#X####.#####.##.#####.####X#
#..........................#
#.####.##.########.##.####.#
#......##....##....##......#
######.##### ## #####.######
     #.##          ##.#
     #.## ###--### ##.#
######.## #      # ##.######
      .   #      #   .      